0 3 4 4 3 0
3 2 3 2 3 2
4 2 2 2 2 4
0 0 0 0 0 0
2 3 2 3 2 3
0 1 0 1 0 1
0 0 0 0 0 0
2 1 0 0 1 2
2 0 2 0 2 0
0 1 0 1 0 1
0 0 0 0 0 0